Filetes de lomo y ensalada de naranja|Filetes de lomo, ensalada preparada, vinagre de módena, naranja|C
Menestra de verduras|Menestra, alcachofas, jamón serrano en trozos|V
Salmón a la naranja|Salmon, naranja, cointreau, cebolla|P
Merluza en salsa verde|Merluza, cebolla, caldo de pescado|P
Merluza a la gallega|Merluza, patatas, cebolla, pimentón|P
Crema de calabaza|Calabaza,Patatas|V
Crepes jamon y queso|Harina, Leche, 1 huevo|O
Hojaldre pollo y brócoli|Masa de hojaldre, brocoli, pollo en trozos, queso cheddar, 1 huevo|O
Fingers de pollo|Pollo de corral, pan rallado, huevo|O
Pizza casera|Harina, levadura fresca|O
Green smoothie|Manzanas granny smith (2), platano (1), espinacas (80 g), miel (30 g)|D
Crema de espinacas|Crema de espinacas congelada (mercadona)|V
Berenjenas con atún|Berenjenas (2), atún, cebolla, tomate frito|V
Filetes de pollo con pure de patatas|Filetes de pollo, patatas, mantequilla|C
Bacalao a la bras|Bacalao, huevos, cebolla, patatas|P
Bacalao con tomate|Bacalao, tomate frito, pimiento rojo, cebolleta|P
Atún con tomate|Atún, tomate natural triturado, pimiento rojo, cebolla|P
Sandwich mixto|Jamón de york, queso en lonchas|O
Hamburguesas|Hamburguesas, tomate natural, queso en lonchas, lechuga|O
Empanadillas|Pasta de empanadillas, huevo, atún, tomate, aceitunas|O
Hojaldre de pisto|Masa de hojaldre, pimiento rojo, pimiento verde, calabacin, cebolla, tomate triturado|O
Cazuelita de calabacin y queso|Calabacín, queso en lonchas, tomate frito, huevos|V
Crema de verduras|Calabacín, puerro, calabaza, cebolla|V
Ensalada de frutas|Rucula, manzana, mango, tomate natural, nueces, salsa de yogur|D
Ensalada de espinacas|Espinacas, tomate, piñones, almendras, champiñones, queso fresco, zumo de limón|D
Sepia a la plancha|Sepia, limón, ajo, perejil, cuscus|P
Sepia con tomate|Sepia, tomate, rellenar!!!!|P
Revuelto de gambas|Gambas, huevos, ajos tiernos, tostada de pan|O
Tortilla francesa|Huevos, quesitos, pavo|O
Fajitas de pollo|Pollo, fajitas, lechuga, tomate, guacamole, queso rallado, cilantro|O
Kebab con pan naan|Kebab mercadona congelado, harina, aceite girasol, lechuga, tomate, hummus mercadona, cilantro|O
Vuelta y vuelta con ensalada|Filetes de pavo, ensalada preparada, vinagre de módena, naranja|C
Crema de calabacín|Patatas, cebolla, calabacín|V
Lenguados con berenjena a la plancha|Lenguados, berenjenas|P